Precinct,Classification,Total Votes,Harris Votes,Trump Votes,Trump Percentage
3435,urban,454,237,217,47.80%
3766,urban,285,133,152,53.33%
2372,rural,383,203,180,47.00%
3757,rural,141,42,99,70.21%
3717,rural,96,25,71,73.96%
3724,urban,498,244,254,51.00%
3732,urban,386,171,215,55.70%
5565,urban,368,199,169,45.92%
3007,urban,484,295,189,39.05%
3064,urban,21,4,17,80.95%
3057,urban,48,18,30,62.50%
2003,urban,156,83,73,46.79%
2710,urban,482,239,243,50.41%
3604,rural,464,227,237,51.08%
7522,urban,619,333,286,46.20%
2614,rural,498,221,277,55.62%
2645,rural,18,6,12,66.67%
2032,urban,174,101,73,41.95%
3217,urban,271,125,146,53.87%
3715,rural,190,53,137,72.11%
3719,urban,459,221,238,51.85%
6685,urban,193,80,113,58.55%
3058,urban,348,154,194,55.75%
3059,urban,425,193,232,54.59%
2067,rural,239,110,129,53.97%
3056,urban,24,3,21,87.50%
3709,rural,139,40,99,71.22%
3061,urban,147,99,48,32.65%
3417,urban,328,171,157,47.87%
3392,urban,191,65,126,65.97%
3587,rural,273,117,156,57.14%
6609,rural,482,203,279,57.88%
3747,urban,313,152,161,51.44%
3382,rural,175,69,106,60.57%
3588,rural,368,152,216,58.70%
3787,urban,202,95,107,52.97%
3780,urban,225,77,148,65.78%
3769,urban,149,67,82,55.03%
4633,urban,249,149,100,40.16%
2352,rural,283,111,172,60.78%
3464,urban,198,77,121,61.11%
3771,urban,139,67,72,51.80%
3071,urban,45,16,29,64.44%
6045,urban,380,153,227,59.74%
4423,urban,477,266,211,44.23%
2479,rural,419,194,225,53.70%
3418,rural,93,35,58,62.37%
2360,urban,383,231,152,39.69%
2073,rural,398,206,192,48.24%
3781,rural,351,141,210,59.83%
3607,rural,300,174,126,42.00%
3710,urban,85,40,45,52.94%
3037,urban,221,96,125,56.56%
3606,rural,471,213,258,54.78%
7592,rural,558,210,348,62.37%
2021,urban,470,299,171,36.38%
3074,urban,153,75,78,50.98%
3016,urban,258,124,134,51.94%
3762,urban,408,204,204,50.00%
3373,rural,351,160,191,54.42%
2651,rural,407,180,227,55.77%
2469,rural,277,47,230,83.03%
2457,urban,360,135,225,62.50%
2473,rural,858,69,789,91.96%
2726,rural,721,87,634,87.93%
2770,rural,56,43,13,23.21%
2465,rural,706,225,481,68.13%
2682,rural,258,82,176,68.22%
7614,urban,420,161,259,61.67%
2711,rural,236,80,156,66.10%
2644,rural,288,84,204,70.83%
7059,urban,205,85,120,58.54%
1679,urban,168,70,98,58.33%
5533,urban,260,135,125,48.08%
2743,rural,669,355,314,46.94%
3055,rural,368,158,210,57.07%
6632,urban,125,51,74,59.20%
6468,urban,353,169,184,52.12%
3540,rural,53,10,43,81.13%
4022,urban,362,210,152,41.99%
3385,urban,167,67,100,59.88%
4529,urban,470,306,164,34.89%
2662,rural,346,144,202,58.38%
2051,rural,355,165,190,53.52%
6037,rural,308,142,166,53.90%
2700,rural,263,118,145,55.13%
2737,urban,210,158,52,24.76%
4501,urban,551,334,217,39.38%
3755,urban,243,118,125,51.44%
2654,rural,223,76,147,65.92%
2622,rural,192,60,132,68.75%
3557,rural,263,116,147,55.89%
2008,urban,452,203,249,55.09%
4583,urban,444,282,162,36.49%
2014,urban,441,276,165,37.41%
4506,urban,236,130,106,44.92%
3609,rural,178,79,99,55.62%
4586,urban,526,330,196,37.26%
4400,urban,531,333,198,37.29%
3565,rural,372,155,217,58.33%
5007,urban,346,212,134,38.73%
3758,urban,46,12,34,73.91%
2037,urban,442,169,273,61.76%
2695,rural,365,135,230,63.01%
3039,urban,289,167,122,42.21%
3735,rural,15,5,10,66.67%
3068,urban,141,73,68,48.23%
2752,urban,474,326,148,31.22%
2005,urban,339,154,185,54.57%
5581,urban,269,205,64,23.79%
7674,urban,170,67,103,60.59%
5554,urban,218,115,103,47.25%
4562,urban,255,174,81,31.76%
3547,rural,189,72,117,61.90%
3605,rural,316,43,273,86.39%
3706,rural,414,154,260,62.80%
2011,urban,211,94,117,55.45%
2720,urban,98,69,29,29.59%
4013,urban,524,328,196,37.40%
3011,urban,418,204,214,51.20%
5513,rural,507,266,241,47.53%
5017,urban,437,243,194,44.39%
6538,rural,289,140,149,51.56%
4415,urban,368,243,125,33.97%
3036,urban,127,46,81,63.78%
1004,urban,284,157,127,44.72%
3800,urban,339,143,196,57.82%
2082,rural,216,61,155,71.76%
1689,urban,269,131,138,51.30%
3793,rural,481,198,283,58.84%
6735,urban,434,223,211,48.62%
6517,rural,328,123,205,62.50%
6057,urban,284,135,149,52.46%
3564,rural,23,8,15,65.22%
2004,urban,182,84,98,53.85%
2633,rural,302,102,200,66.23%
4581,urban,548,329,219,39.96%
2387,rural,339,203,136,40.12%
2600,rural,469,207,262,55.86%
5040,urban,280,161,119,42.50%
2605,rural,187,99,88,47.06%
5012,urban,268,167,101,37.69%
5046,urban,423,242,181,42.79%
3366,urban,320,138,182,56.88%
3700,rural,51,23,28,54.90%
4590,urban,215,140,75,34.88%
2611,rural,353,164,189,53.54%
6708,urban,301,142,159,52.82%
7341,urban,424,221,203,47.88%
3773,urban,185,118,67,36.22%
7405,urban,190,85,105,55.26%
3613,rural,206,99,107,51.94%
4585,urban,256,168,88,34.38%
5622,urban,392,211,181,46.17%
3546,rural,507,210,297,58.58%
3730,rural,280,144,136,48.57%
4304,urban,549,361,188,34.24%
6001,rural,769,298,471,61.25%
5578,urban,249,138,111,44.58%
3863,urban,509,252,257,50.49%
4046,urban,105,47,58,55.24%
6044,urban,338,171,167,49.41%
3050,rural,166,58,108,65.06%
7603,rural,345,123,222,64.35%
6652,rural,293,125,168,57.34%
2028,urban,427,244,183,42.86%
6675,urban,162,69,93,57.41%
2663,rural,285,86,199,69.82%
3602,rural,231,106,125,54.11%
3754,urban,373,229,144,38.61%
3748,urban,227,96,131,57.71%
3383,urban,136,43,93,68.38%
7726,urban,122,78,44,36.07%
3027,urban,352,176,176,50.00%
2740,urban,311,207,104,33.44%
5372,urban,233,139,94,40.34%
4559,urban,366,240,126,34.43%
6695,rural,432,201,231,53.47%
1621,urban,173,91,82,47.40%
5572,urban,390,207,183,46.92%
7361,rural,265,70,195,73.58%
7509,urban,168,100,68,40.48%
4597,urban,616,419,197,31.98%
4547,urban,367,217,150,40.87%
5570,urban,405,232,173,42.72%
6718,urban,564,250,314,55.67%
2033,urban,411,222,189,45.99%
5047,urban,202,99,103,50.99%
5583,urban,179,109,70,39.11%
2643,rural,158,61,97,61.39%
4553,urban,347,255,92,26.51%
7411,urban,353,177,176,49.86%
1633,urban,244,129,115,47.13%
7036,urban,435,186,249,57.24%
3576,rural,226,101,125,55.31%
5417,rural,361,201,160,44.32%
5045,urban,249,142,107,42.97%
4024,urban,319,220,99,31.03%
4037,urban,200,129,71,35.50%
7312,urban,407,260,147,36.12%
1669,urban,501,246,255,50.90%
6658,urban,315,133,182,57.78%
7562,rural,612,148,464,75.82%
1605,urban,435,205,230,52.87%
5018,urban,214,142,72,33.64%
4510,urban,137,66,71,51.82%
2430,urban,238,125,113,47.48%
1038,urban,279,123,156,55.91%
4555,urban,665,434,231,34.74%
5038,urban,385,245,140,36.36%
6527,urban,343,116,227,66.18%
7355,rural,340,145,195,57.35%
4019,urban,371,234,137,36.93%
7311,urban,150,87,63,42.00%
6610,rural,344,116,228,66.28%
6062,urban,244,123,121,49.59%
2733,rural,516,320,196,37.98%
2477,rural,146,22,124,84.93%
7055,urban,511,302,209,40.90%
1613,urban,292,130,162,55.48%
6066,urban,329,164,165,50.15%
5031,urban,363,212,151,41.60%
6693,urban,310,174,136,43.87%
7502,urban,197,84,113,57.36%
7047,urban,406,167,239,58.87%
6467,urban,454,203,251,55.29%
7513,urban,389,232,157,40.36%
1000,rural,129,59,70,54.26%
2086,urban,325,186,139,42.77%
6042,rural,497,212,285,57.34%
4040,urban,65,48,17,26.15%
3018,urban,323,135,188,58.20%
1333,urban,155,66,89,57.42%
7022,urban,129,88,41,31.78%
6003,rural,46,27,19,41.30%
4411,urban,294,177,117,39.80%
3038,urban,32,12,20,62.50%
1336,urban,161,93,68,42.24%
7001,urban,285,149,136,47.72%
1631,urban,239,120,119,49.79%
4017,urban,322,239,83,25.78%
4306,urban,330,211,119,36.06%
2126,rural,491,262,229,46.64%
4036,urban,417,263,154,36.93%
4541,urban,700,433,267,38.14%
1651,urban,440,189,251,57.05%
6731,rural,348,163,185,53.16%
7079,urban,388,226,162,41.75%
7028,urban,433,255,178,41.11%
5504,rural,363,189,174,47.93%
5008,urban,379,220,159,41.95%
5589,urban,83,32,51,61.45%
6487,rural,405,104,301,74.32%
5005,urban,387,252,135,34.88%
5011,urban,267,160,107,40.07%
4045,urban,83,46,37,44.58%
5323,urban,440,268,172,39.09%
5029,urban,232,127,105,45.26%
5324,rural,396,180,216,54.55%
6681,urban,65,21,44,67.69%
1354,urban,507,237,270,53.25%
5013,urban,416,252,164,39.42%
5405,rural,488,279,209,42.83%
1072,rural,99,22,77,77.78%
1067,rural,28,8,20,71.43%
7430,rural,338,143,195,57.69%
5412,rural,515,303,212,41.17%
3361,urban,186,91,95,51.08%
7366,rural,770,363,407,52.86%
1351,urban,383,200,183,47.78%
4028,urban,270,213,57,21.11%
5002,urban,460,304,156,33.91%
2025,urban,322,202,120,37.27%
5633,urban,211,125,86,40.76%
6031,urban,201,103,98,48.76%
4020,urban,260,167,93,35.77%
1007,urban,476,257,219,46.01%
4508,urban,482,336,146,30.29%
4309,urban,214,167,47,21.96%
7023,urban,245,138,107,43.67%
2046,urban,437,265,172,39.36%
4461,urban,248,180,68,27.42%
4011,urban,214,117,97,45.33%
5020,urban,203,116,87,42.86%
2606,urban,422,204,218,51.66%
2048,urban,417,183,234,56.12%
2063,urban,169,100,69,40.83%
4526,urban,404,262,142,35.15%
4030,urban,314,237,77,24.52%
1335,urban,199,86,113,56.78%
2746,urban,252,137,115,45.63%
7570,rural,425,179,246,57.88%
2047,urban,229,133,96,41.92%
2511,urban,178,98,80,44.94%
4548,urban,315,230,85,26.98%
2055,urban,408,144,264,64.71%
2666,rural,578,270,308,53.29%
2054,urban,388,156,232,59.79%
2065,rural,197,92,105,53.30%
2079,rural,46,6,40,86.96%
2087,urban,483,300,183,37.89%
5022,urban,306,216,90,29.41%
7003,urban,134,77,57,42.54%
1411,rural,356,140,216,60.67%
5015,urban,270,175,95,35.19%
4387,urban,426,269,157,36.85%
4566,urban,144,95,49,34.03%
5395,urban,65,36,29,44.62%
5612,rural,555,339,216,38.92%
1318,urban,264,118,146,55.30%
4543,urban,292,196,96,32.88%
5001,urban,228,154,74,32.46%
5030,urban,243,135,108,44.44%
4540,urban,169,122,47,27.81%
2013,urban,188,122,66,35.11%
7019,rural,333,134,199,59.76%
1330,urban,268,110,158,58.96%
5425,urban,456,241,215,47.15%
4069,urban,27,17,10,37.04%
3043,urban,188,105,83,44.15%
4528,urban,261,184,77,29.50%
4422,urban,406,212,194,47.78%
4000,urban,177,111,66,37.29%
2074,urban,349,179,170,48.71%
2009,urban,277,167,110,39.71%
7378,rural,270,114,156,57.78%
4504,urban,313,196,117,37.38%
1653,urban,270,161,109,40.37%
6738,urban,523,245,278,53.15%
6625,urban,174,78,96,55.17%
5635,urban,308,153,155,50.32%
6154,rural,374,154,220,58.82%
5501,rural,115,54,61,53.04%
2731,rural,417,123,294,70.50%
7007,urban,153,73,80,52.29%
3014,urban,255,115,140,54.90%
4417,urban,419,230,189,45.11%
4044,urban,511,319,192,37.57%
4034,urban,104,65,39,37.50%
4009,urban,175,103,72,41.14%
4414,urban,419,198,221,52.74%
6706,urban,223,133,90,40.36%
1008,urban,502,237,265,52.79%
4564,urban,467,311,156,33.40%
4623,urban,208,86,122,58.65%
3022,urban,387,178,209,54.01%
5625,urban,574,282,292,50.87%
7527,urban,163,100,63,38.65%
6492,urban,697,282,415,59.54%
6707,rural,230,102,128,55.65%
4018,urban,118,45,73,61.86%
5350,urban,492,272,220,44.72%
1602,urban,367,206,161,43.87%
2730,urban,416,229,187,44.95%
4021,urban,136,63,73,53.68%
5571,urban,305,166,139,45.57%
2015,urban,457,251,206,45.08%
3727,urban,174,57,117,67.24%
2007,urban,92,28,64,69.57%
3364,rural,158,59,99,62.66%
6016,urban,398,229,169,42.46%
5615,urban,68,36,32,47.06%
7507,urban,365,208,157,43.01%
4035,urban,229,148,81,35.37%
5560,urban,246,131,115,46.75%
3021,urban,355,151,204,57.46%
1645,urban,486,259,227,46.71%
1368,urban,279,143,136,48.75%
3363,urban,226,86,140,61.95%
5587,urban,471,248,223,47.35%
6017,urban,439,184,255,58.09%
4421,rural,389,197,192,49.36%
7332,urban,499,278,221,44.29%
4591,urban,49,38,11,22.45%
5563,urban,295,185,110,37.29%
6705,urban,92,57,35,38.04%
4027,urban,257,160,97,37.74%
2673,rural,20,4,16,80.00%
5330,rural,474,259,215,45.36%
2049,urban,225,102,123,54.67%
5624,urban,186,84,102,54.84%
5593,urban,305,140,165,54.10%
4012,urban,259,129,130,50.19%
4650,urban,328,222,106,32.32%
2480,urban,130,71,59,45.38%
2399,urban,314,168,146,46.50%
4420,rural,36,23,13,36.11%
4404,urban,499,297,202,40.48%
5620,urban,392,240,152,38.78%
5586,urban,202,120,82,40.59%
5582,urban,200,114,86,43.00%
6469,urban,486,218,268,55.14%
5545,urban,154,95,59,38.31%
2715,urban,303,152,151,49.83%
3000,urban,298,178,120,40.27%
7004,urban,141,63,78,55.32%
1328,urban,267,103,164,61.42%
5003,urban,34,20,14,41.18%
2080,rural,81,26,55,67.90%
6547,rural,289,123,166,57.44%
2036,urban,403,235,168,41.69%
1349,urban,298,142,156,52.35%
3705,rural,136,46,90,66.18%
2088,urban,221,119,102,46.15%
6431,urban,98,53,45,45.92%
1009,urban,211,72,139,65.88%
2384,rural,82,46,36,43.90%
5384,urban,266,171,95,35.71%
4463,urban,33,22,11,33.33%
3033,urban,27,18,9,33.33%
3009,urban,371,210,161,43.40%
4605,urban,159,100,59,37.11%
5597,urban,425,269,156,36.71%
4716,urban,301,185,116,38.54%
6741,rural,248,94,154,62.10%
1525,rural,203,97,106,52.22%
1518,rural,267,89,178,66.67%
1510,rural,55,15,40,72.73%
6497,rural,246,108,138,56.10%
6528,rural,227,91,136,59.91%
1668,urban,583,246,337,57.80%
1715,rural,88,29,59,67.05%
6509,rural,124,47,77,62.10%
1717,rural,122,48,74,60.66%
1012,rural,132,34,98,74.24%
6552,rural,111,41,70,63.06%
1550,rural,113,31,82,72.57%
1712,rural,274,111,163,59.49%
2060,rural,124,62,62,50.00%
7500,urban,266,136,130,48.87%
5530,rural,365,99,266,72.88%
7017,rural,162,62,100,61.73%
7024,rural,237,78,159,67.09%
5652,rural,139,24,115,82.73%
7039,rural,494,205,289,58.50%
7528,urban,348,204,144,41.38%
7015,urban,105,50,55,52.38%
7526,urban,114,64,50,43.86%
7056,urban,303,139,164,54.13%
5531,rural,83,34,49,59.04%
7625,rural,376,147,229,60.90%
1334,urban,219,88,131,59.82%
4007,urban,143,79,64,44.76%
7634,urban,157,60,97,61.78%
2077,urban,172,103,69,40.12%
4512,urban,399,250,149,37.34%
5037,rural,405,116,289,71.36%
7524,urban,234,136,98,41.88%
1606,rural,300,106,194,64.67%
1396,urban,515,251,264,51.26%
7652,rural,196,64,132,67.35%
1688,urban,133,58,75,56.39%
7417,urban,472,221,251,53.18%
1674,rural,154,66,88,57.14%
1719,rural,37,11,26,70.27%
5044,urban,284,151,133,46.83%
4010,urban,322,157,165,51.24%
5577,urban,164,83,81,49.39%
7352,rural,443,181,262,59.14%
6033,rural,368,193,175,47.55%
7034,urban,45,28,17,37.78%
4031,urban,39,26,13,33.33%
1702,urban,258,100,158,61.24%
7042,rural,273,113,160,58.61%
7715,urban,250,132,118,47.20%
6490,rural,344,149,195,56.69%
4505,urban,273,169,104,38.10%
1390,urban,630,308,322,51.11%
6004,rural,69,24,45,65.22%
1672,rural,484,192,292,60.33%
7037,urban,248,128,120,48.39%
4043,urban,106,56,50,47.17%
2371,rural,225,117,108,48.00%
4641,urban,40,11,29,72.50%
2023,urban,197,110,87,44.16%
7611,rural,402,145,257,63.93%
3003,urban,229,131,98,42.79%
4550,urban,142,84,58,40.85%
3764,urban,437,203,234,53.55%
1394,rural,333,102,231,69.37%
1660,urban,260,135,125,48.08%
1348,urban,336,162,174,51.79%
1356,urban,318,143,175,55.03%
7553,rural,738,196,542,73.44%
2056,rural,12,3,9,75.00%
2440,urban,104,37,67,64.42%
6036,rural,330,147,183,55.45%
7044,urban,83,33,50,60.24%
5547,rural,28,1,27,96.43%
7012,urban,465,247,218,46.88%
7601,rural,586,167,419,71.50%
5025,rural,408,133,275,67.40%
7665,urban,427,188,239,55.97%
4008,urban,136,87,49,36.03%
3391,urban,192,94,98,51.04%
3765,urban,264,161,103,39.02%
7723,urban,266,123,143,53.76%
7097,urban,260,161,99,38.08%
1341,urban,441,183,258,58.50%
3583,rural,206,74,132,64.08%
1682,urban,503,249,254,50.50%
5569,urban,449,206,243,54.12%
5603,urban,216,105,111,51.39%
6545,rural,269,137,132,49.07%
7058,urban,108,43,65,60.19%
7651,rural,260,106,154,59.23%
1619,urban,306,136,170,55.56%
7714,urban,175,101,74,42.29%
3544,rural,155,55,100,64.52%
5550,rural,130,42,88,67.69%
1677,urban,337,136,201,59.64%
6742,rural,65,22,43,66.15%
5584,urban,172,120,52,30.23%
3370,rural,374,168,206,55.08%
7011,urban,11,8,3,27.27%
4502,urban,194,115,79,40.72%
6540,rural,290,124,166,57.24%
3740,rural,375,150,225,60.00%
5591,urban,119,67,52,43.70%
1625,urban,360,211,149,41.39%
6015,urban,174,98,76,43.68%
1514,rural,244,98,146,59.84%
7040,rural,354,107,247,69.77%
7032,urban,68,26,42,61.76%
2045,rural,68,31,37,54.41%
7060,urban,366,171,195,53.28%
3006,urban,58,15,43,74.14%
6007,urban,284,128,156,54.93%
6493,rural,352,140,212,60.23%
6717,urban,243,96,147,60.49%
6725,urban,422,170,252,59.72%
6750,rural,197,83,114,57.87%
5023,rural,461,107,354,76.79%
6713,urban,461,222,239,51.84%
1302,urban,485,202,283,58.35%
2445,rural,131,74,57,43.51%
1001,urban,160,60,100,62.50%
1015,urban,304,130,174,57.24%
1331,urban,229,128,101,44.10%
2717,urban,272,164,108,39.71%
1353,urban,462,252,210,45.45%
6041,urban,62,45,17,27.42%
6514,rural,283,90,193,68.20%
7403,urban,478,195,283,59.21%
7604,rural,489,145,344,70.35%
3045,urban,173,83,90,52.02%
4032,urban,201,107,94,46.77%
7410,urban,136,51,85,62.50%
4413,urban,80,37,43,53.75%
1680,urban,265,114,151,56.98%
7029,urban,509,245,264,51.87%
7531,urban,251,134,117,46.61%
1327,urban,354,179,175,49.44%
5024,rural,364,115,249,68.41%
1346,urban,299,117,182,60.87%
6520,rural,380,169,211,55.53%
2030,urban,222,124,98,44.14%
7675,urban,102,43,59,57.84%
7569,rural,421,175,246,58.43%
2417,urban,51,26,25,49.02%
6704,urban,186,90,96,51.61%
3374,rural,244,98,146,59.84%
3017,urban,345,152,193,55.94%
4613,urban,85,54,31,36.47%
6032,urban,157,89,68,43.31%
6734,urban,141,64,77,54.61%
6715,urban,174,80,94,54.02%
3729,rural,163,78,85,52.15%
1685,urban,120,42,78,65.00%
5403,rural,83,45,38,45.78%
7515,urban,383,184,199,51.96%
6522,rural,180,62,118,65.56%
1696,urban,375,168,207,55.20%
6471,rural,244,139,105,43.03%
7683,urban,159,71,88,55.35%
3030,urban,370,206,164,44.32%
1384,urban,60,41,19,31.67%
7414,urban,291,138,153,52.58%
3414,urban,106,47,59,55.66%
6530,rural,437,198,239,54.69%
4434,urban,15,5,10,66.67%
6018,urban,87,37,50,57.47%
5542,urban,166,102,64,38.55%
2053,rural,127,38,89,70.08%
1344,urban,207,101,106,51.21%
1010,urban,82,45,37,45.12%
7021,urban,225,121,104,46.22%
2464,urban,248,143,105,42.34%
2066,rural,20,7,13,65.00%
6512,rural,191,54,137,71.73%
6719,urban,275,99,176,64.00%
6600,rural,208,90,118,56.73%
6666,rural,348,150,198,56.90%
4402,urban,110,77,33,30.00%
4001,urban,50,20,30,60.00%
3753,urban,96,53,43,44.79%
1039,urban,314,130,184,58.60%
1011,urban,25,9,16,64.00%
4573,urban,60,43,17,28.33%
6648,urban,560,274,286,51.07%
1695,urban,73,15,58,79.45%
7523,urban,31,15,16,51.61%
2444,rural,62,28,34,54.84%
5042,rural,118,71,47,39.83%
6038,urban,255,124,131,51.37%
1352,urban,218,91,127,58.26%
7402,urban,458,223,235,51.31%
7006,urban,123,49,74,60.16%
6753,rural,399,193,206,51.63%
7730,urban,333,155,178,53.45%
6012,urban,136,67,69,50.74%
6728,rural,299,95,204,68.23%
7057,urban,163,56,107,65.64%
7643,rural,256,112,144,56.25%
6034,urban,197,100,97,49.24%
7624,urban,225,111,114,50.67%
1517,rural,242,91,151,62.40%
7684,urban,244,122,122,50.00%
6046,urban,140,66,74,52.86%
7041,rural,286,85,201,70.28%
5556,rural,406,121,285,70.20%
1614,urban,248,108,140,56.45%
1700,urban,490,238,252,51.43%
6030,urban,205,111,94,45.85%
7415,urban,479,201,278,58.04%
3034,urban,104,53,51,49.04%
7334,urban,196,102,94,47.96%
6751,rural,278,112,166,59.71%
7622,urban,115,58,57,49.57%
3013,urban,275,127,148,53.82%
1632,urban,348,180,168,48.28%
7030,urban,91,49,42,46.15%
7512,urban,106,54,52,49.06%
7582,rural,142,51,91,64.08%
7503,urban,96,49,47,48.96%
7501,urban,42,27,15,35.71%
3040,urban,170,62,108,63.53%
1304,urban,439,219,220,50.11%
3763,urban,40,16,24,60.00%
6009,urban,180,79,101,56.11%
5566,urban,492,226,266,54.07%
5585,urban,216,139,77,35.65%
7595,rural,145,43,102,70.34%
1005,urban,159,76,83,52.20%
6657,urban,187,71,116,62.03%
4638,urban,49,29,20,40.82%
6488,rural,41,14,27,65.85%
2776,rural,454,126,328,72.25%
7545,rural,335,81,254,75.82%
7691,urban,234,100,134,57.26%
1389,urban,189,77,112,59.26%
7705,urban,141,50,91,64.54%
7053,urban,58,31,27,46.55%
6533,urban,186,84,102,54.84%
6710,urban,384,217,167,43.49%
1307,urban,190,72,118,62.11%
6011,urban,138,75,63,45.65%
6526,urban,41,15,26,63.41%
3062,urban,371,162,209,56.33%
6656,urban,157,50,107,68.15%
6727,rural,37,13,24,64.86%
2019,urban,50,21,29,58.00%
5041,urban,58,31,27,46.55%
2751,urban,25,11,14,56.00%
2709,urban,96,42,54,56.25%
3069,urban,32,24,8,25.00%
5049,urban,76,34,42,55.26%
1609,urban,241,115,126,52.28%
7552,rural,388,105,283,72.94%
6539,rural,209,114,95,45.45%
1643,urban,78,30,48,61.54%
1751,rural,176,34,142,80.68%
4612,urban,17,16,1,5.88%
1006,urban,256,104,152,59.38%
7707,urban,73,35,38,52.05%
2052,rural,16,0,16,100.00%
5634,urban,138,71,67,48.55%
6499,urban,400,179,221,55.25%
1706,urban,28,13,15,53.57%
5543,urban,101,67,34,33.66%
2725,rural,318,41,277,87.11%
1343,urban,144,58,86,59.72%
7025,urban,84,40,44,52.38%
1016,urban,50,25,25,50.00%
1063,urban,143,65,78,54.55%
6736,urban,189,92,97,51.32%
2449,urban,218,95,123,56.42%
4002,urban,23,13,10,43.48%
2016,urban,26,13,13,50.00%
2632,rural,11,5,6,54.55%
5048,urban,26,15,11,42.31%
2072,rural,35,12,23,65.71%
3041,urban,36,30,6,16.67%
5028,urban,12,6,6,50.00%
2693,rural,14,4,10,71.43%
2602,rural,22,11,11,50.00%
6043,rural,21,13,8,38.10%
1664,urban,124,47,77,62.10%
7663,urban,92,45,47,51.09%
5039,urban,27,17,10,37.04%
1074,rural,322,111,211,65.53%
6014,urban,136,50,86,63.24%
1750,rural,198,65,133,67.17%
2029,urban,36,24,12,33.33%
6498,rural,17,4,13,76.47%
3035,urban,19,13,6,31.58%
2466,rural,252,68,184,73.02%
2775,rural,358,84,274,76.54%
7052,rural,22,18,4,18.18%
1753,rural,14,4,10,71.43%
7641,rural,98,31,67,68.37%
